{
    "l_id": 2,
    "room_num": 1,
    "rooms": [
        {
            "r_id": 0,
            "size": 9,
            "is_box": true,
            "entries": [[0, 4]],
            "layout": [
                ["#", "#", "#", "#", ".", "#", "#", "#", "#"],
                ["#", "#", "#", "#", ".", "#", ".", "#", "#"],
                ["#", ".", ".", "b", ".", "0", ".", ".", "#"],
                ["#", ".", ".", ".", ".", ".", ".", ".", "#"],
                ["#", ".", ".", ".", ".", ".", ".", ".", "#"],
                ["#", ".", ".", ".", ".", ".", ".", ".", "#"],
                ["#", ".", ".", "_", "=", "_", ".", ".", "#"],
                ["#", ".", ".", ".", "p", ".", ".", ".", "#"],
                ["#", "#", "#", "#", "#", "#", "#", "#", "#"]
            ]
        }
    ]
}